0000000000000000000000000000
0000000000000000000000000000
0000000000000000000000000000
6111111111111561111111111115
2z000000000002200000000000z2
2061150611150220611150611502
2020020200020220200020200202
2041130411130430411130411302
2000000000000000000000000002
2061150650611111150650611502
2041130220411561130220411302
2000000220000220000220000002
2061150241150220611320611502
2020020261130430411520200202
2020020220b0s0i0c00220200202
2020020220611111150220200202
2041130430200000020430411302
2000000000200000020000000002
4111150650200000020650611113
0000020220411111130220200000
0000020220000000000220200000
0000020220611111150220200000
6111130430411561130430411115
2000000000000220000000000002
2061150611150220611150611502
2041520411130430411130261302
2000220000000p00000000220002
4150220650611111150650220613
6130430220411561130220430415
2000000220070220000220000002
2061111341150220611341111502
2041111111130430411111111302
2z000000000000000000000000z2
4111111111111111111111111113
0000000000000000000000000000
0000000000000000000000000000